"filename", "language", "Java", "Java Properties", "comment", "blank", "total"
"d:\Dev_BE\src\main\java\js\footballclubmng\FootballclubmngApplication.java", "Java", 12, 0, 0, 5, 17
"d:\Dev_BE\src\main\java\js\footballclubmng\ServletInitializer.java", "Java", 9, 0, 0, 5, 14
"d:\Dev_BE\src\main\java\js\footballclubmng\common\CommonConstant.java", "Java", 238, 0, 15, 93, 346
"d:\Dev_BE\src\main\java\js\footballclubmng\common\FootballclubmngUtils.java", "Java", 49, 0, 0, 11, 60
"d:\Dev_BE\src\main\java\js\footballclubmng\common\MapperUtil.java", "Java", 174, 0, 1, 48, 223
"d:\Dev_BE\src\main\java\js\footballclubmng\config\AuthenticateFilterJwt.java", "Java", 47, 0, 0, 11, 58
"d:\Dev_BE\src\main\java\js\footballclubmng\config\AuthenticationEntryPointHandler.java", "Java", 24, 0, 0, 3, 27
"d:\Dev_BE\src\main\java\js\footballclubmng\config\CustomerUserDetails.java", "Java", 72, 0, 1, 17, 90
"d:\Dev_BE\src\main\java\js\footballclubmng\config\EmailConfig.java", "Java", 24, 0, 0, 5, 29
"d:\Dev_BE\src\main\java\js\footballclubmng\config\GlobalExceptionHandler.java", "Java", 21, 0, 0, 4, 25
"d:\Dev_BE\src\main\java\js\footballclubmng\config\HibernateConfig.java", "Java", 58, 0, 4, 10, 72
"d:\Dev_BE\src\main\java\js\footballclubmng\config\ModelMapperConfig.java", "Java", 15, 0, 1, 4, 20
"d:\Dev_BE\src\main\java\js\footballclubmng\config\TokenProvider.java", "Java", 46, 0, 3, 10, 59
"d:\Dev_BE\src\main\java\js\footballclubmng\config\UserServiceSecurity.java", "Java", 23, 0, 0, 4, 27
"d:\Dev_BE\src\main\java\js\footballclubmng\config\VNPayConfig.java", "Java", 127, 0, 2, 13, 142
"d:\Dev_BE\src\main\java\js\footballclubmng\config\WebSecurityConfig.java", "Java", 105, 0, 0, 20, 125
"d:\Dev_BE\src\main\java\js\footballclubmng\controller\BaseController.java", "Java", 25, 0, 0, 7, 32
"d:\Dev_BE\src\main\java\js\footballclubmng\controller\CartController.java", "Java", 125, 0, 0, 15, 140
"d:\Dev_BE\src\main\java\js\footballclubmng\controller\CartTicketController.java", "Java", 78, 0, 0, 9, 87
"d:\Dev_BE\src\main\java\js\footballclubmng\controller\CategoryController.java", "Java", 60, 0, 0, 11, 71
"d:\Dev_BE\src\main\java\js\footballclubmng\controller\FixturesController.java", "Java", 63, 0, 0, 9, 72
"d:\Dev_BE\src\main\java\js\footballclubmng\controller\NewsController.java", "Java", 140, 0, 0, 19, 159
"d:\Dev_BE\src\main\java\js\footballclubmng\controller\OrderController.java", "Java", 50, 0, 0, 15, 65
"d:\Dev_BE\src\main\java\js\footballclubmng\controller\PaymentController.java", "Java", 43, 0, 4, 11, 58
"d:\Dev_BE\src\main\java\js\footballclubmng\controller\PlayerController.java", "Java", 72, 0, 0, 13, 85
"d:\Dev_BE\src\main\java\js\footballclubmng\controller\ProductController.java", "Java", 83, 0, 0, 14, 97
"d:\Dev_BE\src\main\java\js\footballclubmng\controller\ShippingController.java", "Java", 25, 0, 0, 10, 35
"d:\Dev_BE\src\main\java\js\footballclubmng\controller\TicketController.java", "Java", 11, 0, 14, 5, 30
"d:\Dev_BE\src\main\java\js\footballclubmng\controller\UserController.java", "Java", 217, 0, 0, 31, 248
"d:\Dev_BE\src\main\java\js\footballclubmng\entity\Cart.java", "Java", 24, 0, 0, 6, 30
"d:\Dev_BE\src\main\java\js\footballclubmng\entity\CartItem.java", "Java", 38, 0, 0, 12, 50
"d:\Dev_BE\src\main\java\js\footballclubmng\entity\CartTicket.java", "Java", 21, 0, 0, 7, 28
"d:\Dev_BE\src\main\java\js\footballclubmng\entity\CartTicketItem.java", "Java", 23, 0, 0, 7, 30
"d:\Dev_BE\src\main\java\js\footballclubmng\entity\Category.java", "Java", 25, 0, 0, 9, 34
"d:\Dev_BE\src\main\java\js\footballclubmng\entity\Fixtures.java", "Java", 43, 0, 0, 6, 49
"d:\Dev_BE\src\main\java\js\footballclubmng\entity\ImagesProduct.java", "Java", 25, 0, 0, 9, 34
"d:\Dev_BE\src\main\java\js\footballclubmng\entity\News.java", "Java", 36, 0, 2, 17, 55
"d:\Dev_BE\src\main\java\js\footballclubmng\entity\NewsComment.java", "Java", 26, 0, 4, 11, 41
"d:\Dev_BE\src\main\java\js\footballclubmng\entity\NewsType.java", "Java", 29, 0, 0, 8, 37
"d:\Dev_BE\src\main\java\js\footballclubmng\entity\Order.java", "Java", 41, 0, 0, 16, 57
"d:\Dev_BE\src\main\java\js\footballclubmng\entity\OrderDetail.java", "Java", 34, 0, 0, 12, 46
"d:\Dev_BE\src\main\java\js\footballclubmng\entity\Player.java", "Java", 45, 0, 0, 21, 66
"d:\Dev_BE\src\main\java\js\footballclubmng\entity\Product.java", "Java", 40, 0, 0, 15, 55
"d:\Dev_BE\src\main\java\js\footballclubmng\entity\ProductSize.java", "Java", 27, 0, 0, 10, 37
"d:\Dev_BE\src\main\java\js\footballclubmng\entity\Shipping.java", "Java", 41, 0, 0, 18, 59
"d:\Dev_BE\src\main\java\js\footballclubmng\entity\TicketOrder.java", "Java", 27, 0, 3, 8, 38
"d:\Dev_BE\src\main\java\js\footballclubmng\entity\TicketOrderDetail.java", "Java", 25, 0, 0, 8, 33
"d:\Dev_BE\src\main\java\js\footballclubmng\entity\User.java", "Java", 62, 0, 2, 26, 90
"d:\Dev_BE\src\main\java\js\footballclubmng\enums\EOrderStatus.java", "Java", 8, 0, 0, 4, 12
"d:\Dev_BE\src\main\java\js\footballclubmng\enums\EShipStatus.java", "Java", 7, 0, 0, 5, 12
"d:\Dev_BE\src\main\java\js\footballclubmng\model\bean\UserBean.java", "Java", 17, 0, 0, 5, 22
"d:\Dev_BE\src\main\java\js\footballclubmng\model\dto\CategoryDto.java", "Java", 11, 0, 0, 5, 16
"d:\Dev_BE\src\main\java\js\footballclubmng\model\dto\FixturesDto.java", "Java", 26, 0, 0, 4, 30
"d:\Dev_BE\src\main\java\js\footballclubmng\model\dto\ImagesProductDto.java", "Java", 11, 0, 0, 6, 17
"d:\Dev_BE\src\main\java\js\footballclubmng\model\dto\OrderDetailDto.java", "Java", 14, 0, 0, 4, 18
"d:\Dev_BE\src\main\java\js\footballclubmng\model\dto\OrderDto.java", "Java", 19, 0, 0, 12, 31
"d:\Dev_BE\src\main\java\js\footballclubmng\model\dto\ProductDetailsDto.java", "Java", 31, 0, 0, 16, 47
"d:\Dev_BE\src\main\java\js\footballclubmng\model\dto\ProductDto.java", "Java", 21, 0, 0, 12, 33
"d:\Dev_BE\src\main\java\js\footballclubmng\model\dto\ProductSizeDto.java", "Java", 11, 0, 0, 7, 18
"d:\Dev_BE\src\main\java\js\footballclubmng\model\dto\ShipStatusDto.java", "Java", 11, 0, 0, 3, 14
"d:\Dev_BE\src\main\java\js\footballclubmng\model\dto\ShippingDto.java", "Java", 20, 0, 0, 5, 25
"d:\Dev_BE\src\main\java\js\footballclubmng\model\dto\UserDto.java", "Java", 13, 0, 0, 4, 17
"d:\Dev_BE\src\main\java\js\footballclubmng\model\dto\UserProfileDto.java", "Java", 19, 0, 0, 3, 22
"d:\Dev_BE\src\main\java\js\footballclubmng\model\request\CreateNewsRequest.java", "Java", 21, 0, 0, 4, 25
"d:\Dev_BE\src\main\java\js\footballclubmng\model\request\CreateProductRequest.java", "Java", 35, 0, 0, 12, 47
"d:\Dev_BE\src\main\java\js\footballclubmng\model\request\CustomiseProductRequest.java", "Java", 16, 0, 0, 4, 20
"d:\Dev_BE\src\main\java\js\footballclubmng\model\request\LoginRequest.java", "Java", 11, 0, 0, 3, 14
"d:\Dev_BE\src\main\java\js\footballclubmng\model\request\PaymentRequest.java", "Java", 14, 0, 0, 4, 18
"d:\Dev_BE\src\main\java\js\footballclubmng\model\request\UpdatePasswordRequest.java", "Java", 13, 0, 0, 4, 17
"d:\Dev_BE\src\main\java\js\footballclubmng\model\request\UserRegisterRequest.java", "Java", 28, 0, 0, 5, 33
"d:\Dev_BE\src\main\java\js\footballclubmng\model\request\order\CreateOrderRequest.java", "Java", 17, 0, 0, 7, 24
"d:\Dev_BE\src\main\java\js\footballclubmng\model\request\shipping\ShippingRequest.java", "Java", 16, 0, 0, 5, 21
"d:\Dev_BE\src\main\java\js\footballclubmng\model\request\user\CreateUserRequest.java", "Java", 34, 0, 0, 14, 48
"d:\Dev_BE\src\main\java\js\footballclubmng\model\request\user\DeleteUserRequest.java", "Java", 9, 0, 0, 4, 13
"d:\Dev_BE\src\main\java\js\footballclubmng\model\response\ListCartItemsResponse.java", "Java", 19, 0, 0, 4, 23
"d:\Dev_BE\src\main\java\js\footballclubmng\model\response\ListCartTicketItemResponse.java", "Java", 21, 0, 0, 4, 25
"d:\Dev_BE\src\main\java\js\footballclubmng\model\response\ListNewsResponse.java", "Java", 15, 0, 0, 4, 19
"d:\Dev_BE\src\main\java\js\footballclubmng\model\response\ListNewsTypeResponse.java", "Java", 13, 0, 0, 3, 16
"d:\Dev_BE\src\main\java\js\footballclubmng\model\response\ListOrderDetailsResponse.java", "Java", 19, 0, 0, 3, 22
"d:\Dev_BE\src\main\java\js\footballclubmng\model\response\ListOrderResponse.java", "Java", 17, 0, 0, 5, 22
"d:\Dev_BE\src\main\java\js\footballclubmng\model\response\ListPlayerResponse.java", "Java", 15, 0, 0, 3, 18
"d:\Dev_BE\src\main\java\js\footballclubmng\model\response\ListShippingResponse.java", "Java", 25, 0, 0, 8, 33
"d:\Dev_BE\src\main\java\js\footballclubmng\model\response\LoginResponse.java", "Java", 25, 0, 0, 7, 32
"d:\Dev_BE\src\main\java\js\footballclubmng\model\response\OrderDetailResponse.java", "Java", 16, 0, 0, 3, 19
"d:\Dev_BE\src\main\java\js\footballclubmng\model\response\PaymentResponse.java", "Java", 14, 0, 0, 3, 17
"d:\Dev_BE\src\main\java\js\footballclubmng\model\response\ResponseAPI.java", "Java", 62, 0, 0, 21, 83
"d:\Dev_BE\src\main\java\js\footballclubmng\repository\CartItemRepository.java", "Java", 14, 0, 0, 7, 21
"d:\Dev_BE\src\main\java\js\footballclubmng\repository\CartRepository.java", "Java", 9, 0, 0, 3, 12
"d:\Dev_BE\src\main\java\js\footballclubmng\repository\CartTicketItemRepository.java", "Java", 13, 0, 0, 6, 19
"d:\Dev_BE\src\main\java\js\footballclubmng\repository\CartTicketRepository.java", "Java", 10, 0, 0, 4, 14
"d:\Dev_BE\src\main\java\js\footballclubmng\repository\CategoryRepository.java", "Java", 17, 0, 0, 6, 23
"d:\Dev_BE\src\main\java\js\footballclubmng\repository\FixturesRepository.java", "Java", 11, 0, 0, 4, 15
"d:\Dev_BE\src\main\java\js\footballclubmng\repository\ImagesProductRepository.java", "Java", 13, 0, 0, 7, 20
"d:\Dev_BE\src\main\java\js\footballclubmng\repository\NewsRepository.java", "Java", 19, 0, 0, 6, 25
"d:\Dev_BE\src\main\java\js\footballclubmng\repository\NewsTypeRepository.java", "Java", 17, 0, 1, 5, 23
"d:\Dev_BE\src\main\java\js\footballclubmng\repository\OrderDetailRepository.java", "Java", 9, 0, 0, 6, 15
"d:\Dev_BE\src\main\java\js\footballclubmng\repository\OrderRepository.java", "Java", 12, 0, 0, 7, 19
"d:\Dev_BE\src\main\java\js\footballclubmng\repository\PlayerRepository.java", "Java", 22, 0, 0, 6, 28
"d:\Dev_BE\src\main\java\js\footballclubmng\repository\ProductRepository.java", "Java", 16, 0, 0, 8, 24
"d:\Dev_BE\src\main\java\js\footballclubmng\repository\ProductSizeRepository.java", "Java", 12, 0, 0, 10, 22
"d:\Dev_BE\src\main\java\js\footballclubmng\repository\ShippingRepository.java", "Java", 9, 0, 0, 5, 14
"d:\Dev_BE\src\main\java\js\footballclubmng\repository\TicketOrderDetailRepository.java", "Java", 7, 0, 0, 3, 10
"d:\Dev_BE\src\main\java\js\footballclubmng\repository\TicketOrderRepository.java", "Java", 7, 0, 0, 3, 10
"d:\Dev_BE\src\main\java\js\footballclubmng\repository\UserRepository.java", "Java", 17, 0, 0, 10, 27
"d:\Dev_BE\src\main\java\js\footballclubmng\service\CartService.java", "Java", 18, 0, 0, 7, 25
"d:\Dev_BE\src\main\java\js\footballclubmng\service\CartTicketService.java", "Java", 12, 0, 0, 5, 17
"d:\Dev_BE\src\main\java\js\footballclubmng\service\CategoryService.java", "Java", 12, 0, 0, 4, 16
"d:\Dev_BE\src\main\java\js\footballclubmng\service\FixturesService.java", "Java", 11, 0, 0, 4, 15
"d:\Dev_BE\src\main\java\js\footballclubmng\service\Impl\CartServiceIpml.java", "Java", 209, 0, 3, 27, 239
"d:\Dev_BE\src\main\java\js\footballclubmng\service\Impl\CartTicketServiceImpl.java", "Java", 101, 0, 0, 12, 113
"d:\Dev_BE\src\main\java\js\footballclubmng\service\Impl\CategoryServiceImpl.java", "Java", 74, 0, 0, 13, 87
"d:\Dev_BE\src\main\java\js\footballclubmng\service\Impl\FixturesServiceImpl.java", "Java", 107, 0, 0, 10, 117
"d:\Dev_BE\src\main\java\js\footballclubmng\service\Impl\NewsServiceImpl.java", "Java", 192, 0, 0, 26, 218
"d:\Dev_BE\src\main\java\js\footballclubmng\service\Impl\OrderDetailImpl.java", "Java", 23, 0, 0, 5, 28
"d:\Dev_BE\src\main\java\js\footballclubmng\service\Impl\OrderServiceImpl.java", "Java", 114, 0, 13, 32, 159
"d:\Dev_BE\src\main\java\js\footballclubmng\service\Impl\PaymentServiceImpl.java", "Java", 57, 0, 2, 19, 78
"d:\Dev_BE\src\main\java\js\footballclubmng\service\Impl\PlayerServiceImpl.java", "Java", 101, 0, 0, 13, 114
"d:\Dev_BE\src\main\java\js\footballclubmng\service\Impl\ProductServiceImpl.java", "Java", 156, 0, 8, 45, 209
"d:\Dev_BE\src\main\java\js\footballclubmng\service\Impl\ShipServiceImpl.java", "Java", 66, 0, 5, 19, 90
"d:\Dev_BE\src\main\java\js\footballclubmng\service\Impl\TicketServiceImpl.java", "Java", 74, 0, 0, 11, 85
"d:\Dev_BE\src\main\java\js\footballclubmng\service\Impl\UserServiceImpl.java", "Java", 363, 0, 9, 39, 411
"d:\Dev_BE\src\main\java\js\footballclubmng\service\NewsService.java", "Java", 23, 0, 0, 17, 40
"d:\Dev_BE\src\main\java\js\footballclubmng\service\OrderDetailService.java", "Java", 8, 0, 0, 5, 13
"d:\Dev_BE\src\main\java\js\footballclubmng\service\OrderService.java", "Java", 11, 0, 0, 7, 18
"d:\Dev_BE\src\main\java\js\footballclubmng\service\PaymentService.java", "Java", 8, 0, 0, 6, 14
"d:\Dev_BE\src\main\java\js\footballclubmng\service\PlayerService.java", "Java", 12, 0, 0, 4, 16
"d:\Dev_BE\src\main\java\js\footballclubmng\service\ProductService.java", "Java", 17, 0, 0, 7, 24
"d:\Dev_BE\src\main\java\js\footballclubmng\service\ShipService.java", "Java", 10, 0, 0, 8, 18
"d:\Dev_BE\src\main\java\js\footballclubmng\service\TicketService.java", "Java", 4, 0, 0, 3, 7
"d:\Dev_BE\src\main\java\js\footballclubmng\service\UserService.java", "Java", 30, 0, 1, 4, 35
"d:\Dev_BE\src\main\java\js\footballclubmng\util\EmailUtil.java", "Java", 41, 0, 15, 10, 66
"d:\Dev_BE\src\main\java\js\footballclubmng\util\HelperUtil.java", "Java", 13, 0, 0, 4, 17
"d:\Dev_BE\src\main\java\js\footballclubmng\util\OtpUtil.java", "Java", 15, 0, 0, 3, 18
"d:\Dev_BE\src\main\resources\application.properties", "Java Properties", 0, 16, 0, 7, 23
"Total", "-", 5498, 16, 113, 1369, 6996